10后	一零后
00后	零零后
90后	九零后
80后	八零后
70后	七零后
60后	六零后
50后	五零后
下午茶	下午茶
一点儿	一点儿
一点都不	一点都不
一点也不	一点也不
一日之计在于晨	一日之计在于晨
一年之计在于春	一年之计在于春
日程	日程
查一下	查一下
今日头条	今日头条
春节档	春节档
中国	country
最后	time_last
最后一天	time_last
年内	time_period
内地	内地
一下	一下
闰四月	闰四月
闰4月	闰4月
黎明主演	黎明主演
晚餐	晚餐
晚饭	晚饭
最近一次	最近一次
最近一回	最近一回
内推	内推
欢乐周	欢乐周
每周一悟	每周一悟
号会议室	号会议室
最近一次	最近一次
最近一轮	最近一轮
最近一回	最近一回
最近两次	最近两次
最近三次	最近三次
最近几次	最近几次
最近几回	最近几回
中铁	中铁
最近的	最近的
 
